2111111111111111111111111111111111111111111111111111111111111112
1211111111111111111111111111111111111111111111111111111111111121
1100000000000000000000000000000000000000000000000000000000000011
1100000000000000000000000000000000000000000000000000000000000011
1100000000000000000000000000000000000000000000000000000000000011
1100000000000000000000000000000000000000000000000000000000000011
1100000000000000000000000000000000000000000000000000000000000011
1100000000000000000000000000000000000000000000000000000000000011
1100000000000000000000000000000000000000000000000000000000000011
1100000000000000000000000000000000000000000000000000000000000011
1100000000000000000000000000000000000000000000000000000000000011
1100000000000000000000000000000000000000000000000000000000000011
1100000000000000000000000000000000000000000000000000000000000011
1100000000000000000000000000000000000000000000000000000000000011
1100000000000000000000000000000000000000000000000000000000000011
1100000000000000000000000000000000000000000000000000000000000011
1100000000000000000000000000000000000000000000000000000000000011
1100000000000000000000000000000000000000000000000000000000000011
1100000000000000000000000000000000000000000000000000000000000011
1100000000000000000000000000000000000000000000000000000000000011
1100000000000000000000000000000000000000000000000000000000000011
1100000000000000000000000000000000000000000000000000000000000011
1100000000000000000000000000000000000000000000000000000000000011
1100000000000000000000000000000000000000000000000000000000000011
1100000000000000000000000000000000000000000000000000000000000011
1100000000000000000000000000000000000000000000000000000000000011
1100000000000000000000000000000000000000000000000000000000000011
1100000000000000000000000000000000000000000000000000000000000011
1100000000000000000000000000000000000000000000000000000000000011
1100000000000000000000000000000000000000000000000000000000000011
1100000000000000000000000000000000000000000000000000000000000011
1100000000000000000000000000000000000000000000000000000000000011
1100000000000000000000000000000000000000000000000000000000000011
1100000000000000000000000000000000000000000000000000000000000011
1211111111111111111111111111111111111111111111111111111111111121
2111111111111111111111111111111111111111111111111111111111111112