211111111111111111111111111122
100000000000000000000000000011
100000000000000000000000000011
100000000000000000000000000011
100000000000000000000000000011
100000000000000000000000000011
100000000000000000000000000011
100000000000000000000000000011
100000000000010000000000000011
100000000000000000000000000011
100000000000000000000000000011
100000000000000000000000000011
100000000000000000000000000011
100000000000000000000000000011
100000000000000000000000000011
211111111111111111111111111121
211111111111111111111111111112