211111111111111111111111111152
300000000000000020000000000041
300000000000000000000000000041
300000000000000000000000000041
300000000200000000222220000041
300000000000000000000000000041
300000000000000000000000000041
300000000000000000000000000041
300000200000020000000000000041
300000000000000000000000000041
300000000000000000000000000041
300020000000000000022220000041
300000000000000000000000000041
300000000000000000000000000041
300000000000000000000000000041
688888888888888888888888888871
211111111111111111111111111112