211111111111111111111111111152
300000000000000020000000000041
300000000000000000000000000041
300000000000000000000000000041
300000000200000000222220000041
300000000000000000000000000041
300000000000000000000000000041
300000000000000000000000000041
300000200000220202220202020241
300000000000200202020202020241
300000000000000222220002220041
300020000000000000022220000041
300000000000000000000000000041
300000000000000000000000000041
300000000000000000000000000041
688888888888888888888888888871
211111111111111111111111111112